0 s r r r r 0 0 0 0 0 0 0 r 0
0 0 0 t t r 0 0 0 0 0 0 t r 0
0 0 0 0 t r 0 r r r r r r r 0
0 0 0 t 0 r 0 r 0 t 0 t 0 r 0
0 0 0 0 t r 0 r 0 0 0 0 0 r 0
0 0 r r r r r r r r r r r r 0
0 0 r 0 t r t r 0 t 0 t 0 r 0
0 t r 0 0 r 0 r r r r r r r s
0 0 r 0 t r t 0 0 0 0 0 0 r 0
0 t r 0 0 r 0 0 t 0 t 0 0 r 0
0 0 r 0 0 r r r r r r r r r 0
0 0 r 0 0 0 0 0 0 0 0 0 0 0 0
0 0 s 0 0 0 0 0 0 0 0 0 0 0 0
